SO ./textures/1.xpm
NO ./textures/4.xpm

C 200,150,06

F  250,100,40

S ./textures/brmil.xpm

R 1400 2500

WE ./textures/6.xpm

EA ./textures/7.xpm

        1111111111111111111111111
        1000200000112000020000001
        1011000200111000000200001
        1001000000000N00200000001
111111111011000001110000002000001
111111111111111111111111111111111