
SO ./textures/1.xpm
NO ./textures/4.xpm

C 68,15,15

F  250,255,10

S ./textures/brmil.xpm

R 65155651651656554465 95651688415161665165

WE ./textures/6.xpm

EA ./textures/7.xpm

111111111111111111111111111
111010000000000002000000201
1000000000N1111000000000001
111111111111111111111111111