


SO ./textures/south.xpm


NO ./textures/north.xpm

C 225,30,0

F  250,100,0

S ./textures/armor.xpm

R 1800 900

WE ./textures/west.xpm

EA ./textures/east.xpm

1111111111111111111
1000000020000000001
1000000000000000N01
1111111111111111111