


SO ./textures/south.xpm


NO ./textures/north.xpm

C 225,30,0

F  250,100,0

S ./textures/armor.xpm

R 2200 900

WE ./textures/west.xpm

EA ./textures/east.xpm

        1111111111111111111111111
        1000200000112000020000001
        1011000200111000000200001
        1001000000000N00200000001
111111111011000001110000002000001
111111111111111111111111111111111