
SO ./textures/1.xpm
NO ./textures/4.xpm

C 68,15,15

F  250,255,10

S ./textures/brmil.xpm

R 1000  6624624

WE ./textures/6.xpm

EA ./textures/7.xpm


 111111111111111111111111111
 111010000000000000000000201
111010000000000000000000201
111010000000000000000000201
111010000000020000000000201
111010000000000000000000201
111010000000000000000000201
111010000000000000000000201
1000000000W0121212121210001
111111111111111111111111111
1 1 1 1 1 1 1 1 1 1 1 1