


SO ../textures/south.xpm


NO ../textures/north.xpm

C 225,30,0

F  250,100,0

S ../textures/armor.xpm

R 2200 1000

WE ../textures/west.xpm

EA ../textures/east.xpm


        1111111111111111111111111
        100000000011000000000001
        1011000001110000002000001
        1001000000000000000000001
111111111011000001110000000000001
100000000011000001110111111111111
11110111111111011100000010001
11110111111111011101010010001
11000000110101011100000010001
10002000000000001100000010001
10000000000000011010100100011
11000N00111010101111101111010111
11110111  1110101 101111010001
11111111 1111111 111111111111